111111111111111
1C00000000000E1
111110000011111
100000000000001
111110000011111
100000000000001
111110000011111
1000000000000P1
111111111111111