111111111111111
1C00000000000E1
111110000011111
1C00000000000C1
111110000011111
1C00000000000C1
111110000011111
1000000000000P1
111111111111111